222222222222222222222222222222222222222222222222222222222222222222222222222222222222222222222222222222222222222222
211111111112222222222211111111111111111222222222211111111112211111111112222222222211111111111111111222222222211111111112
211111111112222222222211111111111111111222222222211111111112211111111112222222222211111111111111111222222222211111111112
211111111112222222222211111111111111111222222222211111111112211111111112222222222211111111111111111222222222211111111112
211111111112222222222211111111111111111222222222211111111112211111111112222222222211111111111111111222222222211111111112
222222211112222222222222222211111222222222222222211111111112222222211112222222222222222211111222222222222222211111111112
222222211112222222222222222211111222222222222222211111111112222222211112222222222222222211111222222222222222211111111112
222222211112222222222222222211111222222222222222211111111112222222211112222222222222222211111222222222222222211111111112
211111211112222222222211111111111111111222222222222222222222211111211112222222222211111111111111111222222222222222222222
211111211112222222222211111111111111111222222222222222222222211111211112222222222211111111111111111222222222222222222222
211111211112222222222211111111111111111222222222222222222222211111211112222222222211111111111111111222222222222222222222
211111211111111222222211111111111111111222222222222222222222211111211111111222222211111111111111111222222222222222222222
211111111111111222222211111111111111111222222222222222222222211111111111111222222211111111111111111222222222222222222222
211111111111111222222211111111111111111222222222222222222222211111111111111222222211111111111111111222222222222222222222
211111111111111222222211111111111111111222222222222222222222211111111111111222222211111111111111111222222222222222222222
222222222111111222222222222222222111112222222222211111111112222222222111111222222222222222222111112222222222211111111112
222222222111111222222222222222222111112222222222211111111112222222222111111222222222222222222111112222222222211111111112
222222222111111222222222222222222111112222222222211111111112222222222111111222222222222222222111112222222222211111111112
222222222111111111111111222222222111112222222222211111111112222222222111111111111111222222222111112222222222211111111112
222222222111111111111111222222222111112222222222211111111112222222222111111111111111222222222111112222222222211111111112
222222222111111111111111222222222111112222222222211111111112222222222111111111111111222222222111112222222222211111111112
222222222111111111111111222222222111112222222222211111111112222222222111111111111111222222222111112222222222211111111112
222222222111111111111111222222222111112222222222211111111112222222222111111111111111222222222111112222222222211111111112
211111111111111111111111222222222111112222222222211111111112211111111111111111111111222222222111112222222222211111111112
211111111111111111111111222222222111112222222222211111111112211111111111111111111111222222222111112222222222211111111112
211111111111111111111111222222222111112222222222211111111112211111111111111111111111222222222111112222222222211111111112
211111111111111111111111222222222111112222222222211111111112211111111111111111111111222222222111112222222222211111111112
211111111111111111111111222222222111112222222222211111111112211111111111111111111111222222222111112222222222211111111112
222222222222222222222222222222222222222222222222222222222222222222222222222222222222222222222222222222222222222222222222
