222222222222222222222222222222222222222222222222222222222222222222222222222222222222222222222222222222222222222222222222
222222111111111111111111111111111111111111111222222222222222222222222222222222222222222222222222222222222222222222222222
222222111111111111111111111111111111111111111222222222222222222222222222222222222222111111111111111111111111112222222222
222222111111111111111111111111111111111111111222222222222222222222222222222222222222111111111111111111111111112222222222
222222111111111111111111111111111111111111111222222222222222222222222222222222222222111111111111111111111111112222222222
222222111111111111111111111111111111111111111111111111111111111111111111111111111111111111111111111111111111112222222222
222222111111111111111111111111111111111111111111111111111111111111111111111111111111111111111111111111111111112222222222
222222111111111111111111111111111111111111111111111111111111111111111111111111111111111111111111111111111111112222222222
222222111111111111111111111111111111111111111111111111111111111111111111111111111111111111111111111111111111112222222222
222222111111111111111111111111111111111111111222222222222222111111222222222222222222111111111111111111111111112222222222
222222111111111111111111111111111111111111111222222222222222111111222222222222222222111111111111111111111111112222222222
222222111111111111111111111111111111111111111222222222222222111111222222222222222222111111111111111111111111112222222222
222222222222222222222222222222222222222222222222222222222222111111222222222222222222222222222222222222222222222222222222
222222222222222222222222222222222222222222222222222222222222111111222222222222222222222222222222222222222222222222222222
222222222222222222222222222222222222222222222222222222222222111111222222222222222222222222222222222222222222222222222222
222222222222222222222222222222222222222222222222222222222222111111222222222222222222222222222222222222222222222222222222
222222222222222222222222222222222222222222222222222222222222111111222222222222222222222222222222222222222222222222222222
222222222222222222222222222222222222222222222222222222222222111111222222222222222222222222222222222222222222222222222222
222222222222222222222222222222222222222222222222222111111111111111111111111111112222222222222222222222222222222222222222
222222222222222222222222222222222222222222222222222111111111111111111111111111112222222222222222222211111111111111111112
222222221111111111111111111111111111222222222222222111111111111111111111111111112222222222222222222211111111111111111112
222222221111111111111111111111111111222222222222222111111111111111111111111111112222222222222222222211111111111111111112
222222221111111111111111111111111111111111111111111111111111111111111111111111111111111111111111111111111111111111111112
222222221111111111111111111111111111111111111111111111111111111111111111111111111111111111111111111111111111111111111112
222222221111111111111111111111111111111111111111111111111111111111111111111111111111111111111111111111111111111111111112
222222221111111111111111111111111111222222222222222111111111111111111111111111112222222222222222222211111111111111111112
222222221111111111111111111111111111222222222222222111111111111111111111111111112222222222222222222211111111111111111112
222222221111111111111111111111111111222222222222222111111111111111111111111111112222222222222222222211111111111111111112
222222221111111111111111111111111111222222222222222111111111111111111111111111112222222222222222222211111111111111111112
222222221111111111111111111111111111222222222222222222222222222222222222222222222222222222222222222211111111111111111112
222222221111111111111111111111111111222222222222222222222222222222222222222222222222222222222222222211111111111111111112
222222221111111111111111111111111111222222222222222222222222222222222222222222222222222222222222222222222222111111222222
222222222222221111112222222222222222222222222222222222222222222222222222222222222222222222222222222222222222111111222222
222222222222221111112222222222222222222222222222222222222222222222222222222222222222222222222222222222222222111111222222
222222222222221111112222222222222222222222222222222222222222222222222222222222222222222222222222222222222222111111222222
222222222222221111112222222222222222222222222222222222222222222222222222222222222222222222222222222222222222111111222222
222222222222221111112222222222222222222222222222222222222222222222222222222222222222222222222222222222222222111111222222
222222222222221111112222222222222222222222222222222222222222222222222222222222222222222222222222222222222222111111222222
222222222222221111112222222222222222222222222222222222222222222222222222222222222222222222222222222222222222111111222222
222222222222221111112222222222222222222222222222222222222222222222222222222222222222222222222222222222222222111111222222
222222222222221111112222222222222222222222222222222222222222222222222222222222222222222222222222222222222222111111222222
222222222222221111112222222222222222222222222222222222222222222222222222222222222222222222222222222222222222111111222222
222222222221111111111111111111111111111111111122222222222222222222222222222222222222222222221111111111111111111111111122
222222222221111111111111111111111111111111111122222222222222222222222222222222222222222222221111111111111111111111111122
222222222221111111111111111111111111111111111122222222222222222222222222222222222222222222221111111111111111111111111122
222222222221111111111111111111111111111111111122222222222222222222222222222222222222222222221111111111111111111111111122
222222222221111111111111111111111111111111111122222222222222222222222222222222222222222222221111111111111111111111111122
222222222221111111111111111111111111111111111122222222222222222222222222222222222222222222221111111111111111111111111122
222222222221111111111111111111111111111111111122222222222222222222222222222222222222222222221111111111111111111111111122
222222222221111111111111111111111111111111111122222222222222222222222222222222222222222222221111111111111111111111111122
222222222221111111111111111111111111111111111122222222222222222222222222222222222222222222221111111111111111111111111122
222222222221111111111111111111111111111111111122222222222222222222222222222222222222222222221111111111111111111111111122
222222222221111111111111111111111111111111111122222222222222222222222222222222222222222222221111111111111111111111111122
222222222221111111111111111111111111111111111122222222222222222222222222222222222222222222221111111111111111111111111122
222222222221111111111111111111111111111111111122222222222222222222222222222222222222222222221111111111111111111111111122
222222222221111111111111111111111111111111111122222222222222222222222222222222222222222222221111111111111111111111111122
222222222222222222222221111112222222222222222222222222222222222222222222222222222222222222222222222221111112222222222222
222222222222222222222221111112222222222222222222222222222222222222222222222222222222222222222222222221111112222222222222
222222222222222222222221111112222222222222222222222222222222222222222222222222222222222222222222222221111112222222222222
222222222222222222222221111112222222222222222222222222211111111111111111111111111111111122222222222221111112222222222222
222222222222222222222221111112222222222222222222222222211111111111111111111111111111111122222222222221111112222222222222
222222222222222222222221111112222222222222222222222222211111111111111111111111111111111122222222222221111112222222222222
222222222222222222222221111112222222222222222222222222211111111111111111111111111111111122222222222221111112222222222222
222222222222222222222221111111111111111111111111111111111111111111111111111111111111111111111111111111111112222222222222
222222222222222222222221111111111111111111111111111111111111111111111111111111111111111111111111111111111112222222222222
222222222222222222222221111111111111111111111111111111111111111111111111111111111111111111111111111111111112222222222222
222222222222222222222222222222222222222222222222222222211111111111111111111111111111111122222222222222222222222222222222
222222222222222222222222222222222222222222222222222222211111111111111111111111111111111122222222222222222222222222222222
222222222222222222222222222222222222222222222222222222211111111111111111111111111111111122222222222222222222222222222222
222222222222222222222222222222222222222222222222222222211111111111111111111111111111111122222222222222222222222222222222
222222222222222222222222222222222222222222222222222222222222222222222222222222222222222222222222222222222222222222222222
222222222222222222222222222222222222222222222222222222222222222222222222222222222222222222222222222222222222222222222222


