222222222222222222222222222222222222222222222222222222222222222222222222222222222222222222222222222222222222222222222222
222222222222222222222222222222222222222222111111111111111111111111111111111111111111112222222222222222222222222222222222
222222222222222222222222222222222222222222111111111111111111111111111111111111111111112222222222222222222222222222222222
222222222222222222222222222222222222222222111111111111111111111111111111111111111111112222222222222222222222222222222222
222222222222222222222222222222222222222222111111111111111111111111111111111111111111112222222222222222222222222222222222
222222222222222222222222222222222222222222111111111111111111111111111111111111111111112222222222222222222222222222222222
222222222222222222222222222222222222222222111111111111111111111111111111111111111111112222222222222222222222222222222222
222222222222222222222222222222222222222222111111111111111111111111111111111111111111112222222222222222222222222222222222
222222222222222222222222222222222222222222222222222222222222111112222222222222222222222222222222222222222222222222222222
222222222222222222222222222222222222222222222222222222222222111112222222222222222222222222111111111111111111111111111122
222222222222222222222222222222222222222222222222222222222222111112222222222222222222222222111111111111111111111111111122
222222222222222222222222222222222222222222222222222222222222111112222222222222222222222222111111111111111111111111111122
222222222222222222222222222222222222222222222222222222222222111112222222222222222222222222111111111111111111111111111122
222222222111111111111111111111111111111111112222222222222222111112222222222222222222222222111111111111111111111111111122
222222222111111111111111111111111111111111112222222222222222111112222222222222222222222222111111111111111111111111111122
222222222111111111111111111111111111111111112222222222222222111112222222222222222222222222111111111111111111111111111122
222222222111111111111111111111111111111111112222222222222222111112222222222222222222222222111111111111111111111111111122
222222222111111111111111111111111111111111111111111111111111111111111111111111111111111111111111111111111111111111111122
222222222111111111111111111111111111111111111111111111111111111111111111111111111111111111111111111111111111111111111122
222222222111111111111111111111111111111111111111111111111111111111111111111111111111111111111111111111111111111111111122
222222222111111111111111111111111111111111111111111111111111111111111111111111111111111111111111111111111111111111111122
222222222111111111111111111111111111111111112222222222111111222222222222222222222222222222111111111111111111111111111122
222222222111111111111111111111111111111111112222222222111111222222222222222222222222222222111111111111111111111111111122
222222222111111111111111111111111111111111112222222222111111222222222222222222222222222222111111111111111111111111111122
222222222111111111111111111111111111111111112222222222111111222222222222222222222222222222111111111111111111111111111122
222222222111111111111111111111111111111111112222222222111111222222222222222222222222222222111111111111111111111111111122
222222222111111111111111111111111111111111112222222222111111222222222222222222222222222222111111111111111111111111111122
222222222111111111111111111111111111111111112222222222111111222222222222222222222222222222222222222222222222222222222222
222222222111111111111111111111111111111111112222222222111111222222222222222222222222222222222222222222222222222222222222
222222222222222222222222222222222222222222222222222222111111222222222222222222222222222222222222222222222222222222222222
222222222222222222222222222222222222222222222222222222111111222222222222222222222222222222222222222222222222222222222222
222222222222222222222222222222222222222222222222222222111111222222222222222222222222222222222222222222222222222222222222
222222222222222222222222222222222222222222222222211111111111111111111111111111112222222222222222222222222222222222222222
222222222222222222222222222222222222222222222222211111111111111111111111111111112222222222222222222222222222222222222222
222222222222222222222222222222222222222222222222211111111111111111111111111111112222222222222222222222222222222222222222
222222222222222222222222222222222222222222222222211111111111111111111111111111111111111111111111111111111111122222222222
222222222222222222222222222222222222222222222222211111111111111111111111111111111111111111111111111111111111122222222222
222222222222222222222222222222222222222222222222211111111111111111111111111111111111111111111111111111111111122222222222
222222222222222222222222222222222222222222222222211111111111111111111111111111111111111111111111111111111111122222222222
222222222222222222222222222222222222222222222222211111111111111111111111111111112222222222222222222222111111122222222222
222222222222222222222222222222222222222222222222211111111111111111111111111111112222222222222222222222111111122222222222
222222222222222222222222222222222222222222222222211111111111111111111111111111112222222222222222222222111111122222222222
222222222222222222222222222222222222222222222222222222222222222222222222222222222222222222222222222222111111122222222222
222222222222222222222222222222222222222222222222222222222222222222222222222222222222222222222222222222111111122222222222
222222222222222222222222222222222222222222222222222222222222222222222222222222222222222222222222222222111111122222222222
222222222222222222222222222222222222222222222222222222222222222222222222222222222222222222222222222222111111122222222222
222222222222222222222222222222222222222222222222222222222222222222222222222222222222222222222222222222111111122222222222
222222222222222222222222222222222222222222222222222222222222222222222222222222222222222222222222222222111111122222222222
222222222222222222222222222222222222222222222222222222222222222222222222222222222222222222222222222222111111122222222222
222222222222222222222222222222222222222222222222222222222222222222222222222222222222222222222222222222111111122222222222
222222222222222222222222222222222222222211111111111111111111111111111111111111111111111111111111111111111111122222222222
222222222222222222222222222222222222222211111111111111111111111111111111111111111111111111111111111111111111122222222222
222222222222222222222222222222222222222211111111111111111111111111111111111111111111111111111111111111111111122222222222
222222222222222222222222222222222222222211111111111111111111111111111111111111111111111111111111111111111111122222222222
222222222222222222222222222222222222222211111111111111111111111111111111111111111111111111111111111111111111122222222222
222222222222222222222222222222222222222211111111111111111111111111111111111111111111111111111111111111111111122222222222
222222222222222222222222222222222222222211111111111111111111111111111111111111111111111111111111111111111111122222222222
222222222222222222222222222222222222222211111111111111111111111111111111111111111111111111111111111111111111122222222222
222222222222222222222222222222222222222211111111111111111111111111111111111111111111111111111111111111111111122222222222
222222222222222222222222222222222222222211111111111111111111111111111111111111111111111111111111111111111111122222222222
222222222222222222222222222222222222222211111111111111111111111111111111111111111111111111111111111111111111122222222222
222222222222222222222222222222222222222211111111111111111111111111111111111111111111111111111111111111111111122222222222
222222222222222222222222222222222222222211111111111111111111111111111111111111111111111111111111111111111111122222222222
222222222222222222222222222222222222222211111111111111111111111111111111111111111111111111111111111111111111122222222222
222222222222222222222222222222222222222211111111111111111111111111111111111111111111111111111111111111111111122222222222
222222222222222222222222222222222222222222222222222222222222222222222222222222222222222222222222222222222222222222222222
222222222222222222222222222222222222222222222222222222222222222222222222222222222222222222222222222222222222222222222222
222222222222222222222222222222222222222222222222222222222222222222222222222222222222222222222222222222222222222222222222
222222222222222222222222222222222222222222222222222222222222222222222222222222222222222222222222222222222222222222222222
222222222222222222222222222222222222222222222222222222222222222222222222222222222222222222222222222222222222222222222222
222222222222222222222222222222222222222222222222222222222222222222222222222222222222222222222222222222222222222222222222
222222222222222222222222222222222222222222222222222222222222222222222222222222222222222222222222222222222222222222222222

